    #######
    #......#
    #.......#
#####........#
#.............#
#.............#
#.............#
#.............#
#.............#
#.............#
###############
